------- InflowWind v3.01.* INPUT FILE -------------------------------------------------------------------------
Generated with AeroElasticSE FAST driver
---------------------------------------------------------------------------------------------------------------
                  Echo        - Echo input data to <RootName>.ech (flag)
                  WindType    - switch for wind file type (1=steady; 2=uniform; 3=binary TurbSim FF; 4=binary Bladed-style FF; 5=HAWC format; 6=User defined; 7=native Bladed FF)
                  PropagationDir - Direction of wind propagation (meteoroligical rotation from aligned with X (positive rotates towards -Y) -- degrees)
                  VFlowAng       - Upflow angle (degrees) (not used for native Bladed format WindType=7)
                  VelInterpCubic - Use cubic interpolation for velocity in time (false=linear, true=cubic) [Used with WindType=2,3,4,5,7]
                  NWindVel    - Number of points to output the wind velocity    (0 to 9)
                  WindVxiList - List of coordinates in the inertial X direction (m)
                  WindVyiList - List of coordinates in the inertial Y direction (m)
                  WindVziList - List of coordinates in the inertial Z direction (m)
================== Parameters for Steady Wind Conditions [used only for WindType = 1] =========================
                  HWindSpeed  - Horizontal windspeed                            (m/s)
                  RefHt       - Reference height for horizontal wind speed      (m)
                  PLexp       - Power law exponent                              (-)
================== Parameters for Uniform wind file   [used only for WindType = 2] ============================
                  Filename_Uni - Filename of time series data for uniform wind field.      (-)
                  RefHt_Uni   - Reference height for horizontal wind speed                (m)
                  RefLength   - Reference length for linear horizontal and vertical sheer (-)
================== Parameters for Binary TurbSim Full-Field files   [used only for WindType = 3] ==============
                  FileName_BTS - Name of the Full field wind file to use (.bts)
================== Parameters for Binary Bladed-style Full-Field files   [used only for WindType = 4] =========
                  FilenameRoot - Rootname of the full-field wind file to use (.wnd, .sum)
                  TowerFile   - Have tower file (.twr) (flag)
================== Parameters for HAWC-format binary files  [Only used with WindType = 5] =====================
                  FileName_u  - name of the file containing the u-component fluctuating wind (.bin)
                  FileName_v  - name of the file containing the v-component fluctuating wind (.bin)
                  FileName_w  - name of the file containing the w-component fluctuating wind (.bin)
                  nx          - number of grids in the x direction (in the 3 files above) (-)
                  ny          - number of grids in the y direction (in the 3 files above) (-)
                  nz          - number of grids in the z direction (in the 3 files above) (-)
                  dx          - distance (in meters) between points in the x direction    (m)
                  dy          - distance (in meters) between points in the y direction    (m)
                  dz          - distance (in meters) between points in the z direction    (m)
                  RefHt_Hawc  - reference height; the height (in meters) of the vertical center of the grid (m)
-------------   Scaling parameters for turbulence   ---------------------------------------------------------
                  ScaleMethod - Turbulence scaling method   [0 = none, 1 = direct scaling, 2 = calculate scaling factor based on a desired standard deviation]
                  SFx         - Turbulence scaling factor for the x direction (-)   [ScaleMethod=1]
                  SFy         - Turbulence scaling factor for the y direction (-)   [ScaleMethod=1]
                  SFz         - Turbulence scaling factor for the z direction (-)   [ScaleMethod=1]
                  SigmaFx     - Turbulence standard deviation to calculate scaling from in x direction (m/s)    [ScaleMethod=2]
                  SigmaFy     - Turbulence standard deviation to calculate scaling from in y direction (m/s)    [ScaleMethod=2]
                  SigmaFz     - Turbulence standard deviation to calculate scaling from in z direction (m/s)    [ScaleMethod=2]
-------------   Mean wind profile parameters (added to HAWC-format files)   ---------------------------------
                  URef        - Mean u-component wind speed at the reference height (m/s)
                  WindProfile - Wind profile type (0=constant;1=logarithmic,2=power law)
                  PLExp_Hawc  - Power law exponent (-) (used for PL wind profile type only)
                  Z0          - Surface roughness length (m) (used for LG wind profile type only)
                  XOffset         - Initial offset in +x direction (shift of wind box)
================== LIDAR Parameters ===========================================================================
                  SensorType          - Switch for lidar configuration (0 = None, 1 = Single Point Beam(s), 2 = Continuous, 3 = Pulsed)
                  NumPulseGate        - Number of lidar measurement gates (used when SensorType = 3)
                  PulseSpacing        - Distance between range gates (m) (used when SensorType = 3)
                  NumBeam             - Number of lidar measurement beams (0-5)(used when SensorType = 1)
                  FocalDistanceX      - Focal distance co-ordinates of the lidar beam in the x direction (relative to hub height) (only first coordinate used for SensorType 2 and 3) (m)
                  FocalDistanceY      - Focal distance co-ordinates of the lidar beam in the y direction (relative to hub height) (only first coordinate used for SensorType 2 and 3) (m)
                  FocalDistanceZ      - Focal distance co-ordinates of the lidar beam in the z direction (relative to hub height) (only first coordinate used for SensorType 2 and 3) (m)
                  RotorApexOffsetPos  - Offset of the lidar from hub height (m)
                  URefLid             - Reference average wind speed for the lidar[m/s]
                  MeasurementInterval - Time between each measurement [s]
                  LidRadialVel        - TRUE => return radial component, FALSE => return 'x' direction estimate
                  ConsiderHubMotion   - Flag whether to consider the hub motion's impact on Lidar measurements
====================== OUTPUT ==================================================
                  SumPrint    - Print summary data to <RootName>.IfW.sum (flag)
                  OutList      - The next line(s) contains a list of output parameters.  See OutListParameters.xlsx for a listing of available output channels, (-)
"Wind1VelX"
"Wind1VelY"
"Wind1VelZ"
END of input file (the word "END" must appear in the first 3 columns of this last OutList line)
---------------------------------------------------------------------------------------
